"Posted Date","Transaction Date","Description","Credits","Debits","Status","Running Balance"
"01/15/2024","01/14/2024","WALMART STORE #1234 SEATTLE WA",,"52.11","Posted","2445.89"
"01/15/2024","01/14/2024","STARBUCKS STORE #4567 SEATTLE WA",,"4.25","Posted","2441.64"
"01/15/2024","01/14/2024","AUTOPAY XFINITY CABLE",,"125.00","Posted","2316.64"
"01/14/2024","01/13/2024","SHELL OIL 12345 SEATTLE WA",,"45.67","Posted","2270.97"
"01/14/2024","01/13/2024","DIR DEP AMAZON PAYROLL","1250.00",,"Posted","3520.97"
"01/13/2024","01/12/2024","NETFLIX.COM",,"12.99","Posted","3507.98"
"01/13/2024","01/12/2024","SAFEWAY #1234 SEATTLE WA",,"89.32","Posted","3418.66"